1111111111111
10010000000C1
100001111F001
1P00F1E000001
1111111111111
