0111111
1C00001
100EP01
1000001
1111111
