11111111111111111
1C00010101E000001
10F0P0111000C0001
10000000000000001
100000C00000C0001
10001100111000001
10001101111000001
10000000110000001
110000F0000F00001
11110000000000111
111110C0C00011111
11111111111111111
